Year,State,Total (Pre-primary to 12),Pre-Primary,Primary (1-5),Upper Primary (6-8),Elementary (1-8),Secondary (9-10),Higher Secondary (11-12)
2018-19,India,131113434,2397065,67539828,35131348,102671176,16992666,9052527
2018-19,Andaman and Nicobar Islands,52745,3327,18869,13580,32449,9475,7494
2018-19,Andhra Pradesh,3897043,0,1728840,1208496,2937336,785441,174266
2018-19,Arunachal Pradesh,226114,1740,99776,63461,163237,39281,21856
2018-19,Assam,5065520,266655,2670485,1215369,3885854,665701,247310
2018-19,Bihar,19851353,1782,10652788,5654354,16307142,2650924,891505
2018-19,Chandigarh,156895,7212,53998,43271,97269,27548,24866
2018-19,Chhattisgarh,4120334,31609,1804732,1126590,2931322,729866,427537
2018-19,Dadra and Nagar Haveli,58466,10,27915,13910,41825,10560,6071
2018-19,Daman and Diu,20981,198,9627,5801,15428,3620,1735
2018-19,Delhi,2377476,89180,859025,660942,1519967,478050,290279
2018-19,Goa,44496,719,25197,8241,33438,5741,4598
2018-19,Gujarat,5429274,11827,3232889,1977972,5210861,154914,51672
2018-19,Haryana,2149543,12878,924414,588247,1512661,404225,219779
2018-19,Himachal Pradesh,854569,5778,306196,210331,516527,175531,156733
2018-19,Jammu and Kashmir,1318292,76987,551510,310411,861921,192823,186561
2018-19,Jharkhand,4993773,116606,2673803,1343710,4017513,576046,283608
2018-19,Karnataka,4951087,1318,2467673,1508618,3976291,662901,310577
2018-19,Kerala,1682669,122211,541065,368494,909559,298772,352127
2018-19,Ladakh,27237,4211,9055,5396,14451,4472,4103
2018-19,Lakshadweep,12803,1128,4834,2514,7348,2122,2205
2018-19,Madhya Pradesh,9285196,6339,4206916,2608598,6815514,1629154,834189
2018-19,Maharashtra,5771908,107671,4151676,1191197,5342873,240833,80531
2018-19,Manipur,201236,7242,117122,39112,156234,19611,18149
2018-19,Meghalaya,478172,100354,255377,102099,357476,10301,10041
2018-19,Mizoram,130744,8847,62708,32843,95551,17814,8532
2018-19,Nagaland,179079,40994,73816,38191,112007,16939,9139
2018-19,Odisha,5508288,53028,2776850,1678822,4455672,776951,222637
2018-19,Puducherry,83589,6952,25732,20304,46036,15554,15047
2018-19,Punjab,2475916,220378,901270,620838,1522108,422800,310630
2018-19,Rajasthan,8490185,7744,4050889,2124045,6174934,1418538,888969
2018-19,Sikkim,94513,5616,25786,26629,52415,22304,14178
2018-19,Tamil Nadu,4589477,13902,1730662,1288147,3018809,863353,693413
2018-19,Telangana,2823888,1453,1165093,867387,2032480,557543,232412
2018-19,Tripura,571868,1707,252694,165046,417740,107165,45256
2018-19,Uttar Pradesh,16896167,21111,12138764,4148001,16286765,360800,227491
2018-19,Uttarakhand,968230,425,393744,246123,639867,186192,141746
2018-19,West Bengal,15274308,1037926,6548038,3604258,10152296,2448801,1635285
2019-20,India,130931634,2789038,66775098,34907124,101682222,17033843,9426531
2019-20,Andaman and Nicobar Islands,51905,3636,18575,13323,31898,10331,6040
2019-20,Andhra Pradesh,4042535,19873,1791045,1242286,3033331,785800,203531
2019-20,Arunachal Pradesh,213421,5035,96787,58910,155697,33257,19432
2019-20,Assam,5031895,243328,2639297,1240876,3880173,667732,240662
2019-20,Bihar,19579263,690,10337794,5555551,15893345,2617610,1067618
2019-20,Chandigarh,152561,7221,53029,42659,95688,25860,23792
2019-20,Chhattisgarh,4000147,3503,1758045,1071423,2829468,722899,444277
2019-20,Dadra and Nagar Haveli,61015,675,29196,13523,42719,10946,6675
2019-20,Daman and Diu,22139,133,10384,5924,16308,3789,1909
2019-20,Delhi,2409441,99622,862590,670598,1533188,475096,301535
2019-20,Goa,43547,844,24871,8180,33051,5714,3938
2019-20,Gujarat,5295130,7194,3259701,1818599,5078300,154088,55548
2019-20,Haryana,2131579,10365,916738,566549,1483287,385059,252868
2019-20,Himachal Pradesh,851783,26415,297782,205396,503178,165560,156630
2019-20,Jammu and Kashmir,1271045,74842,534448,304657,839105,192558,164540
2019-20,Jharkhand,4810045,99520,2521273,1315184,3836457,555389,318679
2019-20,Karnataka,4906231,10879,2384192,1519562,3903754,678747,312851
2019-20,Kerala,1725686,141693,557969,373060,931029,293835,359129
2019-20,Ladakh,27072,3901,9149,5346,14495,4394,4282
2019-20,Lakshadweep,12606,1197,5124,2519,7643,1777,1989
2019-20,Madhya Pradesh,9119353,9593,4091553,2586081,6677634,1553179,878947
2019-20,Maharashtra,5646319,103697,4043544,1183220,5226764,240234,75624
2019-20,Manipur,199958,9242,113172,37872,151044,21019,18653
2019-20,Meghalaya,478070,97645,256015,104228,360243,10649,9533
2019-20,Mizoram,127509,9016,61320,32264,93584,16843,8066
2019-20,Nagaland,174882,40703,71204,36928,108132,16760,9287
2019-20,Odisha,5514876,344387,2702076,1629830,4331906,741875,96708
2019-20,Puducherry,83809,7025,26642,20456,47098,15003,14683
2019-20,Punjab,2686786,307163,950110,642950,1593060,451759,334804
2019-20,Rajasthan,8521720,4082,4043344,2100020,6143364,1440407,933867
2019-20,Sikkim,89876,5995,24189,24375,48564,22245,13072
2019-20,Tamil Nadu,4593422,69465,1704663,1282722,2987385,848157,688415
2019-20,Telangana,2837635,4776,1162385,868308,2030693,567633,234533
2019-20,Tripura,562047,2544,249190,158834,408024,104587,46892
2019-20,Uttar Pradesh,16857549,8840,12132357,4161359,16293716,342569,212424
2019-20,Uttarakhand,941454,203,382804,233539,616343,181859,143049
2019-20,West Bengal,15857323,1004096,6652541,3770013,10422554,2668624,1762049
2020-21,India,134904560,2478916,68657346,35835301,104492647,17652151,10280846
2020-21,Andaman and Nicobar Islands,49943,3151,16441,12974,29415,10541,6836
2020-21,Andhra Pradesh,4627208,44256,2177533,1338484,3516017,826857,240078
2020-21,Arunachal Pradesh,234914,7308,107975,61253,169228,36208,22170
2020-21,Assam,5097436,222283,2672887,1270127,3943014,681449,250690
2020-21,Bihar,20874968,139,10973246,5792218,16765464,2877237,1232128
2020-21,Chandigarh,153489,6706,51267,41583,92850,27828,26105
2020-21,Chhattisgarh,4042244,3257,1769429,1073468,2842897,722585,473505
2020-21,Daman and Diu and Dadra and Nagar Haveli,84162,1692,38268,23752,62020,12658,7792
2020-21,Delhi,2542240,99005,882430,694623,1577053,511246,354936
2020-21,Goa,42857,734,23847,7926,31773,6033,4317
2020-21,Gujarat,5334822,5316,3236139,1858939,5095078,178607,55821
2020-21,Haryana,2232333,5533,954543,564093,1518636,413111,295053
2020-21,Himachal Pradesh,847735,28359,291294,209501,500795,158203,160378
2020-21,Jammu and Kashmir,1324301,70679,523452,302717,826169,200843,226610
2020-21,Jharkhand,4873009,55039,2493695,1382848,3876543,579882,361545
2020-21,Karnataka,5031606,15248,2406985,1540704,3947689,725402,343267
2020-21,Kerala,1757209,135050,579353,381150,960503,296976,364680
2020-21,Ladakh,28744,4482,9120,5276,14396,4405,5461
2020-21,Lakshadweep,13114,1083,5294,2457,7751,2244,2036
2020-21,Madhya Pradesh,8904779,17704,4031253,2498949,6530202,1460956,895917
2020-21,Maharashtra,5594726,74092,3960772,1233798,5194570,247183,78881
2020-21,Manipur,201758,8517,114014,38130,152144,22219,18878
2020-21,Meghalaya,482425,96637,259242,106662,365904,11134,8750
2020-21,Mizoram,132230,9477,64768,33367,98135,16298,8320
2020-21,Nagaland,171747,38550,69040,36865,105905,17664,9628
2020-21,Odisha,5213350,20042,2666822,1638230,4305052,790468,97788
2020-21,Puducherry,87867,7197,29544,20984,50528,15371,14771
2020-21,Punjab,2876825,338546,988656,668248,1656904,478659,402716
2020-21,Rajasthan,8955632,2755,4103757,2259161,6362918,1511418,1078541
2020-21,Sikkim,85980,5874,22818,22934,45752,19669,14685
2020-21,Tamil Nadu,4775207,74539,1802985,1305412,3108397,870385,721886
2020-21,Telangana,2896974,3735,1143570,886946,2030516,589398,273325
2020-21,Tripura,536724,3802,240869,150292,391161,88573,53188
2020-21,Uttar Pradesh,17576345,9550,12664274,4340360,17004634,335294,226867
2020-21,Uttarakhand,916631,180,371889,225511,597400,174021,145030
2020-21,West Bengal,16303026,1058399,6909875,3805359,10715234,2731126,1798267
2021-22,India,143240480,2741762,73100775,37956891,111057666,17771002,11670050
2021-22,Andaman and Nicobar Islands,51168,3873,15673,12755,28428,9277,9590
2021-22,Andhra Pradesh,4696207,4588,2213248,1380126,3593374,835982,262263
2021-22,Arunachal Pradesh,233908,8345,100672,59742,160414,35501,29648
2021-22,Assam,5277671,229196,2735536,1313908,4049444,677667,321364
2021-22,Bihar,21989445,0,11619527,6049114,17668641,3001604,1319200
2021-22,Chandigarh,165156,7960,57418,42186,99604,29054,28538
2021-22,Chhattisgarh,4262053,3217,1899255,1123675,3022930,654457,581449
2021-22,Daman and Diu and Dadra and Nagar Haveli,91026,1919,41492,24883,66375,12486,10246
2021-22,Delhi,2796676,123775,984121,761605,1745726,489166,438009
2021-22,Goa,42932,970,23933,7946,31879,5164,4919
2021-22,Gujarat,5570875,5476,3378980,1916527,5295507,189807,80085
2021-22,Haryana,2602484,5994,1158500,639237,1797737,426690,372063
2021-22,Himachal Pradesh,900749,42660,312276,219891,532167,144961,180961
2021-22,Jammu and Kashmir,1473368,146162,561361,310264,871625,209539,246042
2021-22,Jharkhand,5242868,39316,2636425,1496650,4133075,665748,404729
2021-22,Karnataka,5445989,22415,2670886,1596375,4267261,785939,370374
2021-22,Kerala,1862020,162285,635814,397649,1033463,299108,367164
2021-22,Ladakh,29312,4690,9227,5405,14632,4442,5548
2021-22,Lakshadweep,13586,1582,5395,2813,8208,1873,1923
2021-22,Madhya Pradesh,9429734,27589,4297754,2556002,6853756,1483412,1064977
2021-22,Maharashtra,5853094,84323,4146871,1284649,5431520,255507,81744
2021-22,Manipur,216636,12490,117141,38499,155640,22182,26324
2021-22,Meghalaya,477232,93770,255386,108029,363415,11218,8829
2021-22,Mizoram,143345,10584,70136,35705,105841,17005,9915
2021-22,Nagaland,170219,37249,68157,35402,103559,19461,9950
2021-22,Odisha,5255198,2278,2755665,1648036,4403701,750911,98308
2021-22,Puducherry,97368,9739,34055,22519,56574,15384,15671
2021-22,Punjab,3090436,385031,1103915,711062,1814977,448594,441834
2021-22,Rajasthan,9912280,4437,4548975,2530415,7079390,1474241,1354212
2021-22,Sikkim,84411,6293,22054,21149,43203,19159,15756
2021-22,Tamil Nadu,5314845,93808,2080699,1414110,3494809,925673,800555
2021-22,Telangana,3303699,6175,1452199,931282,2383481,590203,323840
2021-22,Tripura,542892,5527,235548,145386,380934,90274,66157
2021-22,Uttar Pradesh,19056651,12711,13587745,4824989,18412734,381606,249600
2021-22,Uttarakhand,980808,389,429586,232969,662555,160915,156949
2021-22,West Bengal,16564139,1134946,6835150,4055937,10891087,2626792,1911314