Year,State,Total (Pre-primary to 12),Pre-Primary,Primary (1-5),Upper Primary (6-8),Elementary (1-8),Secondary (9-10),Higher Secondary (11-12)
2018-19,India,92194512,8071713,41583378,19569512,61152890,12893437,10076472
2018-19,Andaman and Nicobar Islands,22835,5089,10428,4223,14651,1994,1101
2018-19,Andhra Pradesh,3672881,0,1760639,815657,2576296,508117,588468
2018-19,Arunachal Pradesh,97052,14441,56773,18252,75025,5727,1859
2018-19,Assam,1520773,230592,721525,300975,1022500,168739,98942
2018-19,Bihar,2552522,257088,1009500,449881,1459381,374265,461788
2018-19,Chandigarh,94048,14740,33760,19831,53591,12909,12808
2018-19,Chhattisgarh,1728537,241466,789219,363666,1152885,197551,136635
2018-19,Dadra and Nagar Haveli,24524,3208,12121,5226,17347,2556,1413
2018-19,Daman and Diu,15432,2261,8353,2884,11237,1517,417
2018-19,Delhi,1880160,182355,900104,411155,1311259,217510,169036
2018-19,Goa,43667,9292,27111,3926,31037,2075,1263
2018-19,Gujarat,4497916,259661,2122176,1172021,3294197,548940,395118
2018-19,Haryana,3560430,282622,1514707,837106,2351813,556360,369635
2018-19,Himachal Pradesh,621166,95838,274467,130607,405074,76600,43654
2018-19,Jammu and Kashmir,1215889,253842,529431,258055,787486,129781,44780
2018-19,Jharkhand,1227223,67303,315535,255950,571485,284598,303837
2018-19,Karnataka,5434481,586012,2623560,1136461,3760021,637225,451223
2018-19,Kerala,1734002,216451,849287,365251,1214538,197051,105962
2018-19,Ladakh,28961,6506,13059,6160,19219,2641,595
2018-19,Lakshadweep,0,0,0,0,0,0,0
2018-19,Madhya Pradesh,6704433,564105,3210063,1556912,4766975,818604,554749
2018-19,Maharashtra,6453934,566226,3161092,1322942,4484034,775351,628323
2018-19,Manipur,451131,53000,185517,107104,292621,61655,43855
2018-19,Meghalaya,247283,56182,114026,28221,142247,30299,18555
2018-19,Mizoram,149083,27445,70352,27758,98110,13139,10389
2018-19,Nagaland,284617,46401,113525,61924,175449,39007,23760
2018-19,Odisha,1361354,75506,641547,254955,896502,107987,281359
2018-19,Puducherry,157260,22611,65007,32856,97863,20452,16334
2018-19,Punjab,3220607,516915,1309618,673717,1983335,415224,305133
2018-19,Rajasthan,8852298,1039608,3884208,1889253,5773461,1133707,905522
2018-19,Sikkim,48199,13648,22844,7116,29960,3171,1420
2018-19,Tamil Nadu,6447472,1193013,2853941,1139914,3993855,696939,563665
2018-19,Telangana,3754303,140951,1825063,785929,2610992,497164,505196
2018-19,Tripura,123667,25506,58469,23889,82358,10942,4861
2018-19,Uttar Pradesh,20640711,320049,8760100,4558421,13318521,4128218,2873923
2018-19,Uttarakhand,1255452,121576,614134,281742,895876,136314,101686
2018-19,West Bengal,2070209,560204,1122117,259572,1381689,79108,49208
2019-20,India,98209302,9296290,44168879,20830223,64999102,13358800,10555110
2019-20,Andaman and Nicobar Islands,23076,5039,10485,4366,14851,2092,1094
2019-20,Andhra Pradesh,4007299,164402,1872734,822731,2695465,510687,636745
2019-20,Arunachal Pradesh,111958,21030,60116,21072,81188,7008,2732
2019-20,Assam,1640289,237836,771934,338797,1110731,185108,106614
2019-20,Bihar,3350418,330078,1341130,634629,1975759,492063,552518
2019-20,Chandigarh,94069,14605,34050,20020,54070,13285,12109
2019-20,Chhattisgarh,1932268,349751,852859,384223,1237082,203424,142011
2019-20,Dadra and Nagar Haveli,26068,3154,13076,5466,18542,2721,1651
2019-20,Daman and Diu,15575,2353,8244,3000,11244,1524,454
2019-20,Delhi,1908759,192282,905585,418481,1324066,217662,174749
2019-20,Goa,43585,8971,27140,4064,31204,2159,1251
2019-20,Gujarat,4708909,325392,2211911,1167623,3379534,576260,427723
2019-20,Haryana,3711339,308939,1572779,866679,2439458,569916,393026
2019-20,Himachal Pradesh,630841,96756,278730,132342,411072,77739,45274
2019-20,Jammu and Kashmir,1260284,257651,554326,266608,820934,135565,46134
2019-20,Jharkhand,1366963,81731,361712,289648,651360,322320,311552
2019-20,Karnataka,5685875,575879,2662937,1191388,3854325,660568,595103
2019-20,Kerala,1821731,247847,886914,376022,1262936,201484,109464
2019-20,Ladakh,29135,6237,13139,6448,19587,2727,584
2019-20,Lakshadweep,0,0,0,0,0,0,0
2019-20,Madhya Pradesh,7288066,898805,3379752,1645901,5025653,817079,546529
2019-20,Maharashtra,6663311,576278,3252207,1392213,4644420,815370,627243
2019-20,Manipur,462744,56383,188731,108440,297171,63556,45634
2019-20,Meghalaya,263365,58526,121296,31094,152390,32564,19885
2019-20,Mizoram,152137,27658,69737,29576,99313,13909,11257
2019-20,Nagaland,286077,46645,115064,62224,177288,38677,23467
2019-20,Odisha,1494954,1702,765148,293729,1058877,122586,311789
2019-20,Puducherry,160188,22696,64994,34137,99131,20841,17520
2019-20,Punjab,3345863,525512,1326768,715735,2042503,469564,308284
2019-20,Rajasthan,9242216,1153388,4049469,1957547,6007016,1172324,909488
2019-20,Sikkim,48833,13630,23515,7278,30793,3120,1290
2019-20,Tamil Nadu,6415398,1157772,2818122,1161994,3980116,701391,576119
2019-20,Telangana,3984609,264443,1890235,826236,2716471,506682,497013
2019-20,Tripura,129352,26656,60120,24589,84709,11990,5997
2019-20,Uttar Pradesh,22069303,451733,9646636,4955895,14602531,4114954,2900085
2019-20,Uttarakhand,1298229,125020,625108,294418,919526,145684,107999
2019-20,West Bengal,2536216,659510,1332176,335610,1667786,124197,84723
2020-21,India,95157082,7067697,43009553,21088676,64098229,13358678,10632478
2020-21,Andaman and Nicobar Islands,22089,3686,10461,4519,14980,2229,1194
2020-21,Andhra Pradesh,3505297,155391,1513040,755086,2268126,487271,594509
2020-21,Arunachal Pradesh,88144,10934,48242,18193,66435,7760,3015
2020-21,Assam,1647409,217987,769343,352177,1121520,196051,111851
2020-21,Bihar,3389583,251240,1358751,677826,2036577,525993,575773
2020-21,Chandigarh,91576,13222,33692,19922,53614,13317,11423
2020-21,Chhattisgarh,1824071,260420,848537,375614,1224151,193257,146243
2020-21,Daman and Diu and Dadra and Nagar Haveli,37376,3680,18549,8323,26872,4495,2329
2020-21,Delhi,1781795,148333,826330,409949,1236279,215941,181242
2020-21,Goa,40382,7021,25468,4334,29802,2256,1303
2020-21,Gujarat,4376834,181107,2093632,1131437,3225069,560507,410151
2020-21,Haryana,3440885,183002,1458919,853291,2312210,547626,398047
2020-21,Himachal Pradesh,579342,65415,263894,130391,394285,75547,44095
2020-21,Jammu and Kashmir,1240551,221701,560838,272173,833011,136345,49494
2020-21,Jharkhand,1355868,69743,351796,283838,635634,332103,318388
2020-21,Karnataka,5317640,259174,2539417,1218694,3758111,679588,620767
2020-21,Kerala,1735940,209567,847683,372078,1219761,196461,110151
2020-21,Ladakh,29691,6129,13325,6591,19916,2948,698
2020-21,Lakshadweep,0,0,0,0,0,0,0
2020-21,Madhya Pradesh,7094440,766246,3303696,1719673,5023369,765407,539418
2020-21,Maharashtra,6537755,394698,3200560,1444241,4644801,864493,633763
2020-21,Manipur,461572,51300,187120,108466,295586,64944,49742
2020-21,Meghalaya,263613,55510,122729,31796,154525,33662,19916
2020-21,Mizoram,142674,23476,64786,29652,94438,13339,11421
2020-21,Nagaland,278271,43033,112079,61604,173683,38972,22583
2020-21,Odisha,1627444,109377,766314,330141,1096455,129083,292529
2020-21,Puducherry,150076,14652,62581,34353,96934,20819,17671
2020-21,Punjab,3235701,398095,1306947,737376,2044323,492121,301162
2020-21,Rajasthan,8732616,748107,4073583,1946950,6020533,1098307,865669
2020-21,Sikkim,47612,12855,23477,7123,30600,3004,1153
2020-21,Tamil Nadu,5909228,805110,2679516,1137182,3816698,695775,591645
2020-21,Telangana,3964350,227835,1840598,878916,2719514,515770,501231
2020-21,Tripura,126502,21413,59285,26048,85333,13337,6419
2020-21,Uttar Pradesh,22056925,392184,9588070,5007658,14595728,4110672,2958341
2020-21,Uttarakhand,1282798,90303,618015,305672,923687,152104,116704
2020-21,West Bengal,2741032,645751,1418280,387389,1805669,167174,122438
2021-22,India,88271316,5820991,38936394,20013229,58949623,12847281,10653421
2021-22,Andaman and Nicobar Islands,20802,2976,9800,4523,14323,2162,1341
2021-22,Andhra Pradesh,3321792,72367,1424096,734685,2158781,471757,618887
2021-22,Arunachal Pradesh,94940,15839,49944,18811,68755,7110,3236
2021-22,Assam,1595135,198859,720244,347938,1068182,195529,132565
2021-22,Bihar,3306257,231738,1296746,662425,1959171,507623,607725
2021-22,Chandigarh,88519,11950,32765,19616,52381,13293,10895
2021-22,Chhattisgarh,1643600,224219,756897,341086,1097983,173055,148343
2021-22,Daman and Diu and Dadra and Nagar Haveli,35223,3192,16567,8051,24618,4641,2772
2021-22,Delhi,1624522,128834,730571,380444,1111015,204119,180554
2021-22,Goa,39113,6875,24086,4286,28372,2300,1566
2021-22,Gujarat,4155768,157791,1955314,1085802,3041116,524294,432567
2021-22,Haryana,3301867,215283,1342458,815942,2158400,522646,405538
2021-22,Himachal Pradesh,536204,62214,238648,122804,361452,71468,41070
2021-22,Jammu and Kashmir,1235033,246965,539814,265437,805251,134441,48376
2021-22,Jharkhand,1307487,62004,325723,269839,595562,333826,316095
2021-22,Karnataka,5153185,238303,2406481,1208785,3615266,686706,612910
2021-22,Kerala,1624221,189129,779282,352448,1131730,188403,114959
2021-22,Ladakh,29758,6028,13145,6596,19741,3107,882
2021-22,Lakshadweep,0,0,0,0,0,0,0
2021-22,Madhya Pradesh,6523496,712250,2951878,1618895,4570773,688919,551554
2021-22,Maharashtra,6392405,332266,3058071,1453598,4511669,892307,656163
2021-22,Manipur,430166,43417,165655,103878,269533,65025,52191
2021-22,Meghalaya,265667,54913,120709,32663,153372,33642,23740
2021-22,Mizoram,137212,20751,61822,29477,91299,12982,12180
2021-22,Nagaland,273491,39341,109743,61037,170780,39260,24110
2021-22,Odisha,1361051,40240,670003,279641,949644,123115,248052
2021-22,Puducherry,133980,11748,52610,31212,83822,20347,18063
2021-22,Punjab,2864397,407569,1165572,616139,1781711,380577,294540
2021-22,Rajasthan,7584938,486039,3564895,1756369,5321264,943425,834210
2021-22,Sikkim,47581,13125,22913,7110,30023,3139,1294
2021-22,Tamil Nadu,5229947,558778,2363753,1038819,3402572,680473,588124
2021-22,Telangana,3514338,143967,1546425,842378,2388803,512102,469466
2021-22,Tripura,129032,21197,58630,27028,85658,14444,7733
2021-22,Uttar Pradesh,21095448,386589,8787874,4834295,13622169,4107018,2979672
2021-22,Uttarakhand,1238714,92771,574798,297467,872265,153296,120382
2021-22,West Bengal,1936027,381464,998462,333705,1332167,130730,91666