Year,State,Total (Pre-primary to 12),Pre-Primary,Primary (1-5),Upper Primary (6-8),Elementary (1-8),Secondary (9-10),Higher Secondary (11-12)
2018-19,India,27978999,448977,5730599,7926832,13657431,7924543,5948048
2018-19,Andaman and Nicobar Islands,1883,60,530,454,984,403,436
2018-19,Andhra Pradesh,263499,0,100634,64719,165353,42678,55468
2018-19,Arunachal Pradesh,18604,504,9412,5426,14838,2606,656
2018-19,Assam,458882,514,2443,300614,303057,100338,54973
2018-19,Bihar,184794,1120,52967,58772,111739,54020,17915
2018-19,Chandigarh,8425,389,1916,1626,3542,1307,3187
2018-19,Chhattisgarh,89841,942,31317,23593,54910,19010,14979
2018-19,Dadra and Nagar Haveli,2433,0,1362,626,1988,445,0
2018-19,Daman and Diu,5211,0,916,1673,2589,1154,1468
2018-19,Delhi,159135,993,44371,51341,95712,35472,26958
2018-19,Goa,223361,19368,71574,59790,131364,40356,32273
2018-19,Gujarat,1827012,2772,62901,106458,169359,1102293,552588
2018-19,Haryana,16946,654,4538,4219,8757,4214,3321
2018-19,Himachal Pradesh,0,0,0,0,0,0,0
2018-19,Jammu and Kashmir,197,59,86,52,138,0,0
2018-19,Jharkhand,341000,14700,164677,95877,260554,44232,21514
2018-19,Karnataka,1563931,9208,410532,426925,837457,500076,217190
2018-19,Kerala,2681059,148470,917765,714338,1632103,514527,385959
2018-19,Ladakh,472,0,403,69,472,0,0
2018-19,Lakshadweep,0,0,0,0,0,0,0
2018-19,Madhya Pradesh,157490,1988,46800,29795,76595,40929,37978
2018-19,Maharashtra,10839385,172505,2504396,3286945,5791341,2700510,2175029
2018-19,Manipur,29041,831,16892,6160,23052,3567,1591
2018-19,Meghalaya,385676,58032,136387,97153,233540,65977,28127
2018-19,Mizoram,21197,0,1765,5311,7076,9268,4853
2018-19,Nagaland,0,0,0,0,0,0,0
2018-19,Odisha,927677,607,25948,152602,178550,396597,351923
2018-19,Puducherry,30244,2488,11100,8259,19359,5585,2812
2018-19,Punjab,229568,2374,57364,57764,115128,52263,59803
2018-19,Rajasthan,0,0,0,0,0,0,0
2018-19,Sikkim,3757,153,964,1095,2059,841,704
2018-19,Tamil Nadu,2300344,2843,682464,699890,1382354,488934,426213
2018-19,Telangana,109502,1971,51018,28491,79509,19419,8603
2018-19,Tripura,28352,57,7322,7746,15068,6218,7009
2018-19,Uttar Pradesh,4849774,970,284660,1561620,1846280,1607564,1394960
2018-19,Uttarakhand,166062,761,8614,53877,62491,54116,48694
2018-19,West Bengal,54245,3644,16561,13552,30113,9624,10864
2019-20,India,27498530,484292,5598903,7767921,13366824,7778881,5868533
2019-20,Andaman and Nicobar Islands,1871,58,538,480,1018,414,381
2019-20,Andhra Pradesh,251003,1124,94609,62252,156861,39889,53129
2019-20,Arunachal Pradesh,19750,911,9818,5553,15371,2763,705
2019-20,Assam,461786,560,2627,302728,305355,100398,55473
2019-20,Bihar,188259,732,52016,57535,109551,55317,22659
2019-20,Chandigarh,8690,614,2066,1639,3705,1313,3058
2019-20,Chhattisgarh,83935,677,29433,22098,51531,17485,14242
2019-20,Dadra and Nagar Haveli,1927,0,851,648,1499,428,0
2019-20,Daman and Diu,4992,0,731,1648,2379,1090,1523
2019-20,Delhi,155443,1122,43548,50481,94029,33996,26296
2019-20,Goa,220353,15452,72372,59751,132123,40748,32030
2019-20,Gujarat,1811986,3021,57000,98519,155519,1095911,557535
2019-20,Haryana,13450,762,3781,3247,7028,2955,2705
2019-20,Himachal Pradesh,0,0,0,0,0,0,0
2019-20,Jammu and Kashmir,221,54,95,47,142,25,0
2019-20,Jharkhand,338120,15228,157804,97425,255229,49947,17716
2019-20,Karnataka,1546326,7431,396804,416584,813388,497542,227965
2019-20,Kerala,2740593,185594,928588,719807,1648395,507386,399218
2019-20,Ladakh,826,0,605,186,791,35,0
2019-20,Lakshadweep,0,0,0,0,0,0,0
2019-20,Madhya Pradesh,145285,2184,42793,26934,69727,37703,35671
2019-20,Maharashtra,10588760,172573,2451765,3248394,5700159,2643162,2072866
2019-20,Manipur,29955,991,17001,6361,23362,4008,1594
2019-20,Meghalaya,390698,59012,137433,98080,235513,67314,28859
2019-20,Mizoram,21790,0,1823,5376,7199,9653,4938
2019-20,Nagaland,0,0,0,0,0,0,0
2019-20,Odisha,911348,655,26068,144811,170879,381056,358758
2019-20,Puducherry,28241,2249,9921,8067,17988,5375,2629
2019-20,Punjab,220224,3094,56264,55383,111647,49976,55507
2019-20,Rajasthan,0,0,0,0,0,0,0
2019-20,Sikkim,3823,257,945,1147,2092,732,742
2019-20,Tamil Nadu,2225308,3171,650685,684054,1334739,473655,413743
2019-20,Telangana,103902,2806,48490,27272,75762,17658,7676
2019-20,Tripura,27694,110,7168,7452,14620,6139,6825
2019-20,Uttar Pradesh,4744874,889,273339,1491755,1765094,1574171,1404720
2019-20,Uttarakhand,164224,612,7928,52178,60106,53614,49892
2019-20,West Bengal,42873,2349,13994,10029,24023,7023,9478
2020-21,India,26845527,399195,5360834,7468084,12828918,7700861,5916553
2020-21,Andaman and Nicobar Islands,1872,41,518,466,984,374,473
2020-21,Andhra Pradesh,259354,2034,98870,58944,157814,38594,60912
2020-21,Arunachal Pradesh,19625,612,9798,5465,15263,2863,887
2020-21,Assam,458158,503,2486,299024,301510,97502,58643
2020-21,Bihar,194609,418,50358,57114,107472,59784,26935
2020-21,Chandigarh,8347,310,2181,1572,3753,1343,2941
2020-21,Chhattisgarh,78556,616,28137,20284,48421,15430,14089
2020-21,Daman and Diu and Dadra and Nagar Haveli,7075,0,1562,2364,3926,1548,1601
2020-21,Delhi,152598,1002,40372,48686,89058,35249,27289
2020-21,Goa,218884,12761,71464,59517,130981,41928,33214
2020-21,Gujarat,1783008,1424,52214,91615,143829,1102011,535744
2020-21,Haryana,11374,380,3153,2710,5863,2480,2651
2020-21,Himachal Pradesh,0,0,0,0,0,0,0
2020-21,Jammu and Kashmir,193,29,94,46,140,24,0
2020-21,Jharkhand,322009,9231,146001,95652,241653,51096,20029
2020-21,Karnataka,1506780,3873,369403,398514,767917,501108,233882
2020-21,Kerala,2751582,180769,945690,722932,1668622,505907,396284
2020-21,Ladakh,818,33,537,211,748,37,0
2020-21,Lakshadweep,0,0,0,0,0,0,0
2020-21,Madhya Pradesh,126755,1264,39243,24236,63479,29955,32057
2020-21,Maharashtra,10246432,113057,2294413,3145053,5439466,2608075,2085834
2020-21,Manipur,30089,1016,17073,6661,23734,3806,1533
2020-21,Meghalaya,390348,57236,140563,99054,239617,67241,26254
2020-21,Mizoram,21166,0,1758,5546,7304,9162,4700
2020-21,Nagaland,0,0,0,0,0,0,0
2020-21,Odisha,923707,286,25121,150665,175786,397513,350122
2020-21,Puducherry,25690,1246,9083,7616,16699,5317,2428
2020-21,Punjab,205191,2501,53430,50310,103740,45331,53619
2020-21,Rajasthan,0,0,0,0,0,0,0
2020-21,Sikkim,4052,226,1010,1210,2220,826,780
2020-21,Tamil Nadu,2197618,2667,642509,661443,1303952,475620,415379
2020-21,Telangana,94467,1702,40981,26519,67500,16734,8531
2020-21,Tripura,26871,132,6907,6890,13797,5783,7159
2020-21,Uttar Pradesh,4579520,603,244145,1360160,1604305,1521352,1453260
2020-21,Uttarakhand,152184,373,6747,47205,53952,49070,48789
2020-21,West Bengal,46595,2850,15013,10400,25413,7798,10534
2021-22,India,27039457,391597,5413098,7443846,12856944,7632234,6158682
2021-22,Andaman and Nicobar Islands,1891,36,491,441,932,371,552
2021-22,Andhra Pradesh,211692,328,77156,50076,127232,33103,51029
2021-22,Arunachal Pradesh,20860,856,10401,5783,16184,2844,976
2021-22,Assam,381954,632,2375,216948,219323,90653,71346
2021-22,Bihar,197306,476,47755,56653,104408,57715,34707
2021-22,Chandigarh,8800,373,2158,1618,3776,1377,3274
2021-22,Chhattisgarh,74249,531,27247,18476,45723,12660,15335
2021-22,Daman and Diu and Dadra and Nagar Haveli,7109,0,1527,2416,3943,1544,1622
2021-22,Delhi,150909,1016,39738,48726,88464,31990,29439
2021-22,Goa,222937,14711,73337,60078,133415,39402,35409
2021-22,Gujarat,1814425,1424,52449,88311,140760,1036120,636121
2021-22,Haryana,9146,296,2458,2126,4584,1903,2363
2021-22,Himachal Pradesh,0,0,0,0,0,0,0
2021-22,Jammu and Kashmir,209,47,86,43,129,33,0
2021-22,Jharkhand,315854,6491,140452,96911,237363,51747,20253
2021-22,Karnataka,1492350,4288,378536,391496,770032,497449,220581
2021-22,Kerala,2828548,192159,1001380,738361,1739741,507520,389128
2021-22,Ladakh,718,0,520,165,685,33,0
2021-22,Lakshadweep,0,0,0,0,0,0,0
2021-22,Madhya Pradesh,111896,1347,34527,19317,53844,24103,32602
2021-22,Maharashtra,10238929,99691,2291484,3098892,5390376,2583231,2165631
2021-22,Manipur,30452,1157,17830,6602,24432,3798,1065
2021-22,Meghalaya,384856,55220,135751,98761,234512,66978,28146
2021-22,Mizoram,22096,0,1624,5665,7289,9421,5386
2021-22,Nagaland,0,0,0,0,0,0,0
2021-22,Odisha,858901,119,24873,127036,151909,364952,341921
2021-22,Puducherry,24198,1031,8423,7036,15459,5271,2437
2021-22,Punjab,191635,2719,54128,47546,101674,38719,48523
2021-22,Rajasthan,0,0,0,0,0,0,0
2021-22,Sikkim,3971,216,923,1210,2133,853,769
2021-22,Tamil Nadu,2239360,2597,685037,656268,1341305,472193,423265
2021-22,Telangana,90601,1293,38576,25248,63824,16054,9430
2021-22,Tripura,26799,138,7252,6241,13493,5508,7660
2021-22,Uttar Pradesh,4886841,541,236524,1508645,1745169,1620725,1520406
2021-22,Uttarakhand,156815,115,6646,48492,55138,48079,53483
2021-22,West Bengal,33150,1749,11434,8259,19693,5885,5823